0 0 0 0 0 0 0 0 0 0 0 0 0 0 0 0
0 E1 0 0 0 0 0 0 0 0 0 0 0 0 E1 0
0 0 0 0 TL T T T T T T TR 0 0 0 0
0 0 T T 0 0 0 0 0 0 0 0 0 T 0 0
0 0 0 0 0 0 0 0 0 0 0 0 0 0 0 0
T T T T T T T 0 0 T T T T T T T
0 E1 0 0 0 0 0 0 0 0 0 0 0 0 E1 0
0 0 0 T T T T T T T T T T 0 0 0
0 0 0 0 0 0 0 0 P 0 0 0 0 0 0 0
T T T T 0 0 T T T T 0 0 T T T T
0 0 0 0 0 0 0 0 0 0 0 0 0 0 0 0
T T T T T T T T T T T T T T T T
