0 0 0 0 0 0 0 0 0 0 0 0 0 0 0 0
0 0 0 0 0 0 0 0 0 0 0 0 0 0 0 0
0 0 0 0 0 0 0 0 0 0 0 0 0 0 0 0
0 0 0 0 0 0 0 P 0 0 0 0 0 0 0 0
0 0 0 0 0 0 0 0 0 0 0 0 0 0 0 0
0 0 T T T T T T T T T T T T 0 0
0 0 0 0 B2 0 0 0 0 0 0 0 0 0 0 0
T T T T T T 0 0 0 0 T T T T T T
0 0 0 0 0 0 0 0 0 0 0 0 0 0 0 0
0 0 T T 0 0 0 0 0 0 0 0 T T 0 0
0 0 0 0 0 0 0 0 0 0 0 0 0 0 0 0
T T T T T T T T T T T T T T T T
